############
#          #
#  ######  #
#       # E#
#       #  #
#       #  #
#       #  #
#       #  #
#       #  #
#S ######  #
#          #
############
