############
#E         #
#          #
#          #
#   ###    #
#   #S#    #
#   # #    #
#   # #    #
#          #
#          #
#          #
############
