############
#E         #
#          #
#          #
#!!!!!! !!!#
#!!!!!! !!!#
#!!!!!! !!!#
#!!!!!! !!!#
#          #
#          #
#S         #
############
